000000000000000000000000000000000000000000000000000000000000000000000000000000000000000000
ZZZ000000000000000000000000000ZZZ000000000000000000000000000ZZZ000000000000000E00000000000
0000000000000000ZZZZZZ000000000000000000000000ZZZZZZ000000000000000000000000ZZZZZZ00000000
00000YYYY00000000000000000000000000YYYY00000000000000000000000000YYYY000000000000000000000
00RRRR0000E00000000000E0000000000000000E00000000000E000000000000000000E000000000000000000
00000000ZZZ0000000000YYYY0000000000000ZZZ0000000000YYYY0000000000000ZZZ0000000000YYYY00000
0YYYY00000000RR0000000000000000YYYY0000000RRR0000000000000000YYYY000000000RRR0000000000000
000000000000YYYY0000000RRR0000000000000000YYYY00000000000000000000000000YYYY00000000000000
000000000R0000000000E000000000000000000000000000E0000RRR0000000000000000000000E00000000000
XXXXXXXXXXXXXXXXXXXXXXXXXXXXXXXXXXXXXXXXXXXXXXXXXXXXXXXXXXXXXXXXXXXXXXXXXXXXXXXXXXXXXXXXXX