Z00ZZZZZZZZ00ZZZZZZZZ00ZZZZZZZ
000000000000000000000000000000
0000000E0000000000E00000000E00
ZZ00ZZZZZZZZ00ZZZZZZZZ00ZZZZZZ
000000000000000000000000000000
0E000000E000000000E000000000E0
ZZZRRZZZZZZZZRRZZZZZZZZRRZZZZZ
000000000000000000000000000000
0000000000000000000000E0000000
XXXXXXXXXXXXXXXXXXXXXXXXXXXXXX