XXXXXXXXXXXXXXXXXXXX
00000000000000000000
0000E000E000E000E000
0000000000000000000
YYYYYYYYYYYYYYYYYYYY
00000000000000000000
00000000000000000000
00RRRRRRRRRERRR0E00
00000000000000000000
ZZZZZZZZZZZZZZZZZZZZ